111111111111111111111111111111111111111111111111111111111111111111111111111111111111111111111111111111111111111111111111111111111111111111111111
111111111111111111111111111111111111111111111111111111111111111111111111111111111111111111111111111111111111111111111111111111111111111111111111
111111111111111111111111111111111110011001111111111111111111111111111111111111111111111111111111111111100110011111111111111111111111111111111111
111111111111111111111111111111111100000000111111111111111111111111000001100000111111111111111111111111000000001111111111111111111111111111111111
111111111111111111111111111110011000000000011111111111111111111110000000000000011111111111111111111110000000000110011111111111111111111111111111
111111111111111100111111111100000000000000001111111111111111111100000000000000001111111111111111111100000000000000001111111111001111111111111111
111111111110011000011111111000000000000000000111111111111110011000000000000000000110011111111111111000000000000000000111111110000110011111111111
111111111100000000001111110000000000000000000011111111111100000000000000000000000000001111111111110000000000000000000011111100000000001111111111
111111111000000000000111100000000000000000000001111111111000000000000000000000000000000111111111100000000000000000000001111000000000000111111111
111111110000000000000000000000000000000000000000111111111000000000000000000000000000000111111111000000000000000000000000000000000000000011111111
111111100000000000000000000000000000000000000000011111111100000000000000000000000000001111111110000000000000000000000000000000000000000001111111
111111000000000000000000000000000000000000000000011111111110000000000000000000000000011111111110000000000000000000000000000000000000000000111111
111110000000000000000000000000000000000000000000001111111111000000000000000000000000111111111100000000000000000000000000000000000000000000011111
111100000000000000000000000000000000000000000000000111000111100000000000000000000001111000111000000000000000000000000000000000000000000000001111
111100000000000000000000000000000000000000000000000000000011110000000000000000000011110000000000000000000000000000000000000000000000000000001111
111110000000000000000000000000000001111110000000000000000001111000000000000000000111100000000000000000011111100000000000000000000000000000011111
111110000000000000000000000000000011111111100000000000000000111000000000000000000111000000000000000001111111110000000000000000000000000000011111
111100000000000000000000000000000111111111110000000000000000111000000000000000000111000000000000000011111111111000000000000000000000000000001111
111100000000000000000000000000000111111111111000000000000000110000000000000000000011000000000000000111111111111000000000000000000000000000001111
111110000000000000000000000000000111111111111100000000000000100000000000000000000001000000000000001111111111111000000000000000000000000000011111
111110000000000000000000000000000111111111111100000000000000000000000000000000000000000000000000001111111111111000000000000000000000000000011111
111100000000000000000000000000000111111111111100000000000000000000111111111111000000000000000000001111111111111000000000000000000000000000001111
111100000000000000000000000000001111111111100000000000000000000001111111111111100000000000000000000001111111111100000000000000000000000000001111
111110000000000000000000000000011111111111000000000000000000000011100000000001110000000000000000000000111111111110000000000000000000000000011111
111111000000000000000000000000111110111110000000000000000000000000000000000000000000000000000000000000011111011111000000000000000000000000111111
111111100000000000000000000001111100011111000000000000000000000000000000000000000000000000000000000000111110001111100000000000000000000001111111
111111110000000000000000000001111000001111000000000000000000000000000000000000000000000000000000000000111100000111100000000000000000000011111111
111111111000000000000000000001110000000110000000000000000000000000000000000000000000000000000000000000011000000011100000000000000000000111111111
111111111000000000000000000000110000000000000000000000000000000000000000000000000000000000000000000000000000000011000000000000000000000111111111
111111110000000000000000000000010000000000000000000110000000000000000001100000000000000000011000000000000000000010000000000000000000000011111111
111111110000000000000000000000000000000000000000001111000000000000000011110000000000000000111100000000000000000000000000000000000000000011111111
111111111000000000000000000000000000000000000000011111100000000000000111111000000000000001111110000000000000000000000000000000000000000111111111
111111111100000001111000000000000000000000000001111111110000000000000111111000000000000011111111100000000000000000000000000111100000001111111111
111111111110011011111111000000000000000000000011111111111000000000000011110000000000000111111111110000000000000000000000111111110110011111111111
111111111111111111111111100000000000000000000011111111111000000000000001100000000000000111111111110000000000000000000001111111111111111111111111
111111111111111111111111110000000000000000000001111111110000000000000000000000000000000011111111100000000000000000000011111111111111111111111111
111111111111111111111111100000000000000000000000111111111111000000000000000000000000111111111111000000000000000000000001111111111111111111111111
111111111111111111111111110000000000000000000001111011111110000000000000000000000000011111110111100000000000000000000011111111111111111111111111
111111111111111111111111110000000000000000000011111001111100000000000000000000000000001111100111110000000000000000000011111111111111111111111111
111111111111111111110011100000000000000000000111110000000000000000000000000000000000000000000011111000000000000000000001110011111111111111111111
111111111111111111100001000000000000000000111111100000000000000000000000000000000000000000000001111111000000000000000000100001111111111111111111
111111111111111111000000000000000000000011111111000000000000000000000000000000000000000000000000111111110000000000000000000000111111111111111111
111111111111111100000000000000000000000111111110000000000000000001000000000000100000000000000000011111111000000000000000000000001111111111111111
111111111111111000000000000000000000000111111000000000000000000011000000000000110000000000000000000111111000000000000000000000000111111111111111
111111111111000000000000000000000000001111111000000000000000000111000000000000111000000000000000000111111100000000000000000000000000111111111111
111111111110000000000000000000000110111111111000000000000000000111000000000000111000000000000000000111111111011000000000000000000000011111111111
111111111100000000000000000000001111111111110000000000000000000111000000000000111000000000000000000011111111111100000000000000000000001111111111
111111111000000000000000000000001111111110000000000000000000000111000000000000111000000000000000000000011111111100000000000000000000000111111111
111111111100000000000000000000001111111110000000000000000000000111000000000000111000000000000000000000011111111100000000000000000000001111111111
111111111000000000000000000000000111111100000000000000000000000111000000000000111000000000000000000000001111111000000000000000000000000111111111
111111111000000000000000000000000011111000000000000000000000000111000000000000111000000000000000000000000111110000000000000000000000000111111111
111111110000000000000000000000000011111000000000000000000000000111000000000000111000000000000000000000000111110000000000000000000000000011111111
111111110000000000000000000000000001111000000000000000000000000011000000000000110000000000000000000000000111100000000000000000000000000011111111
111111111000000000000000000000000000111000000000000000000000000001000000000000100000000000000000000000000111000000000000000000000000000111111111
111111111000000000000000000000000000110000000000000000000000000000000000000000000000000000000000000000000011000000000000000000000000000111111111
111111110000000000000000000000000000100000000000000000011111000000000000000000000000111110000000000000000001000000000000000000000000000011111111
111111111000000000000000000000000000000000000000000000111111100000000000000000000001111111000000000000000000000000000000000000000000000111111111
111111111110000000000000000000000000000000000011111111111100000000000000000000000000001111111111110000000000000000000000000000000000011111111111
111111111110000000000000000000000000000000001111111111111100000000000000000000000000001111111111111100000000000000000000000000000000011111111111
111111111111000000001000000000000000000000011111111110111100000000000000000000000000001111011111111110000000000000000000000100000000111111111111
111111111111100000011100000000000000000000111111111100011110000000000000000000000000011110001111111111000000000000000000001110000001111111111111
111111111111110000111111000000000000000000001111111000000111000000000000000000000000111000000111111100000000000000000000111111000011111111111111
111111111111111111111111100000000000000000000000000000000011100000000000000000000001110000000000000000000000000000000001111111111111111111111111
111111111111111111111111110000000000000000000000000000000001110000000000000000000011100000000000000000000000000000000011111111111111111111111111
111111111111111111111111110000000000000000000000000000000000111000000000000000000111000000000000000000000000000000000011111111111111111111111111
111111111001100111111111110000000000000000000000000000000000011100000000000000001110000000000000000000000000000000000011111111111001100111111111
111111110000000011111111100000000000000000000000000000000000001110000000000000011100000000000000000000000000000000000001111111110000000011111111
111111100000000001100111000000000000000000000000000000000000000111100000000001111000000000000000000000000000000000000000111001100000000001111111
111111000000000000000000000000001100000000000000000000000000000011110000000011110000000000000000000000000000001100000000000000000000000000111111
111111000000000000000000000001011110000000000000000000000000000011111000000111110000000000000000000000000000011110100000000000000000000000111111
111111100000000000000000000011111111110000000000000000000000000001111100001111100000000000000000000000000011111111110000000000000000000001111111
111111100000000000000000000111111111111000000000000000000000000000111100001111000000000000000000000000000111111111111000000000000000000001111111
111111000000000000000000000111111111111100000000000000000000000000011000000110000000000000000000000000001111111111111000000000000000000000111111
111110000000000000000000000111111111111110000000000000000000000000000000000000000000000000000000000000011111111111111000000000000000000000011111
111100000000000000000000000000001111111110000000000000011110000000000000000000000000011110000000000000011111111100000000000000000000000000001111
111100000000000000000000000000001111111110000000000000011111000000000000000000000000111110000000000000011111111100000000000000000000000000001111
111110000000000000000000000000000111111100000000000000001111100000000000000000000001111100000000000000001111111000000000000000000000000000011111
111110000000000000000000000000000011111100000000000000000111100000000000000000000001111000000000000000001111110000000000000000000000000000011111
111100000000000000000000000000000001111100000000000000000000000000000000000000000000000000000000000000001111100000000000000000000000000000001111
111100000000000000000000000000000011111000000000000000000000000000000000000000000000000000000000000000000111110000000000000000000000000000001111
111110000000000000000000000000000111111100000000000000000000000000000000000000000000000000000000000000001111111000000000000000000000000000011111
111110000000000000000000000000011111111110000000000000000000000000000000000000000000000000000000000000011111111110000000000000000000000000011111
111100000000000000000000000000111111111110000000000000000000000000000000000000000000000000000000000000011111111111000000000000000000000000001111
111100000000000000000000111001100111111110000000000000000000000000000111111000000000000000000000000000011111111001100111000000000000000000001111
111110000000000000000000011111000011111110000000000000000000000000001111111100000000000000000000000000011111110000111110000000000000000000011111
111111000000000000000010001110000001111111000000000001110000000000011111111110000000000011100000000000111111100000011100010000000000000000111111
111111100000000000001111000000000000111111100000000011100000000000111111111111000000000001110000000001111111000000000000111100000000000001111111
111111110000000000011111100000000000011111111000000111000000000000111111111111000000000000111000000111111110000000000001111110000000000011111111
111111111111111111111111100000000000001111111111111100000000000001111111111111100000000000001111111111111100000000000001111111111111111111111111
111111111111111111111111100000000000000111111111111000000000000001111111111111100000000000000111111111111000000000000001111111111111111111111111
111111111111111111111111000000000000000111111111110000000000000011111111111111110000000000000011111111111000000000000000111111111111111111111111
111111100110011001100110000000000000000111111111100000000000010111100111111001111010000000000001111111111000000000000000011001100110011001111111
111111000000000000000000000000000000000111111100000000000000111111000000000000111111000000000000001111111000000000000000000000000000000000111111
111110000000000000000000000000000000000111111100000000000001111110000000000000011111100000000000001111111000000000000000000000000000000000011111
111100000000000000000000000000000000000111111110000000000011111100000000000000001111110000000000011111111000000000000000000000000000000000001111
111100000000000000000000000000000000001111111110000000000011111000000000000000000111110000000000011111111100000000000000000000000000000000001111
111110000000000000000000000000000000011111111100000000000001110000000000000000000011100000000000001111111110000000000000000000000000000000011111
111110001110000000000000000000000000011111111000000000000000000000000000000000000000000000000000000111111110000000000000000000000000000000011111
111100001110000000000000000000000000001111110000000000000000000000000000000000000000000000000000000011111100000000000000000000000000000000001111
111100001110000111000000000000000000001111100000000000100000000000000000000000000000000001000000000001111100000000000000000000000000000000001111
111110000000001111100000000000000000011111000001100001110000000000000000000000000000000011100001100000111110000000000000000000000000000000011111
111110000110001111100000000000000000011110000011110011111000000000000000000000000000000111110011110000011110000000000000000000000000000000011111
111100001100001111100000000000000000001100000111111111111100000000000000000000000000001111111111111000001100000000000000000000000000000000001111
111100000110000111000000000000000000000110001111111111111110000000000000000000000000011111111111111100011000000000000000000000000000000000001111
111110000000000000000000000000000000000011011111111111111111000000000000000000000000111111111111111110110000000000000000000000000000000000011111
111110000110000000000000000000000000000001111111111111111111100000000000000000000001111111111111111111100000000000000000000000000000000000011111
111100000011000000000000000000000000000000111111111111111111110000000000000000000011111111111111111111000000000000000000000000000000000000001111
111100000001100110111000000000000000000000111111111111111111100000000000000000000001111111111111111111000000000000000000000000000000000000001111
111110000000001100111000000000000000000001111111111111111111000000000000000000000000111111111111111111100000000000000000000000000000000000011111
111111000000000000111000000000000000000011111111111111111111000000000000000000000000111111111111111111110000000000000000000000000000000000111111
111111100000000000000000000000000001100111111111111111111111100110000000000000011001111111111111111111111001100000000000000000000000000001111111
111111110000000000000000000000000011111111111111111111111111111111000000000000111111111111111111111111111111110000000000000000000000000011111111
111111111001100000000000011001100111111111111111111111111111111111111111111111111111111111111111111111111111111001100110000000000001100111111111
111111111111110000000000111111111111111111111111111111111111111111111111111111111111111111111111111111111111111111111111000000000011111111111111
111111111111111111111111111111111111111111111111111111111111111111111111111111111111111111111111111111111111111111111111111111111111111111111111
